9
10
+-------+
|   |   |
| |   | |
| +---+ |
| |     |
|-+ + +-|
|   | | |
| | +-+ |
| |     |
+-------+
s 8 1  
g 4 1
